1111111111111111111111111111111111111
1000000000000000000000000000000000001
100000E00000C00000000C000000000000001
1000000C00011111111111111000000000001
10000000000000C000000000000P000000001
1111111111111111111111111111111111111