
1111111111111111111111111111111111111
1000000000000000000000000000000000001
100000E0P0000000000000000000000000001
1000000000011111111111111000000000001
1000000000000000000000000000000000001
1111111111111111111111111111111111111
1111111111111111111111111111111111111
1111111111111111111111111111111111111
1111111111111111111111111111111111111
1111111111111111111111111111111111111
1111111111111111111111111111111111111
1111111111111111111111111111111111111
1111111111111111111111111111111111111
1111111111111111111111111111111101111
1111111111111111111111111111111111111