1111111111111111111111
10000C0000000000000001
1000000000000000000001
10C0C00000P00000000001
1000001100111111000001
1000000100000001000001
1000000111111001000001
10000C0000001001000001
10000C000001000000001
100000000000C0000000E1
1111111111111111111111