1111111111111111111111
1P00000000000000000001
1000000000000000000001
1000000000000000000001
1000001100111111000001
1000000100000001000001
1000000111111001000001
1000000000001001000001
1000000000001000000001
100000000000C0000000E1
1111111111111111111111