1111111111111111111111111111
10000C0000000000000000000001
1000000000000000000000000001
10C0C00000P00000000000000001
1000001100111111000000000001
1000000100000001000000000001
1000000111111001000000000001
10000C0000001001000000000001
10000C0000010000000000000001
100000000000C0000000E0000001
1111111111111111111111111111